0;0;0;0;0;0;0;0;0;0;0;0;0;0;0;0;0;0;0;0;0;0;0;0;0;0;0;0;0;0;0;0;0;0;0;0;0
0;0;0;0;0;0;0;0;0;0;0;0;0;0;0;0;0;0;0;0;0;0;0;0;0;0;0;0;0;0;0;0;0;0;0;0;0
0;0;0;0;0;0;0;0;0;0;0;0;0;0;0;0;0;0;0;0;0;0;0;0;5;0;0;0;0;0;0;0;0;0;0;0;0
0;0;0;0;0;0;0;0;0;0;0;0;0;0;0;0;0;0;0;0;0;6;5;0;0;0;0;0;0;0;0;0;0;0;0;0;0
0;0;0;0;0;5;0;0;0;0;0;0;0;0;0;0;0;0;0;0;0;3;3;3;0;0;5;0;0;0;0;0;0;0;0;0;0
0;0;0;0;5;0;0;0;0;5;0;0;5;0;0;0;0;0;0;0;0;0;0;3;3;0;0;5;0;0;0;0;0;0;0;0;0
0;0;0;0;5;0;0;0;0;0;0;0;0;0;0;0;0;0;0;3;0;0;0;3;0;3;0;0;5;0;0;0;0;0;0;0;0
0;0;0;5;0;0;0;0;0;0;0;0;0;0;0;0;0;0;0;0;0;0;0;3;0;0;3;0;0;5;0;0;0;0;0;0;5
0;0;0;5;4;4;4;0;0;1;0;0;1;0;0;0;0;3;0;0;0;0;0;3;0;0;0;3;0;0;0;0;0;0;0;0;5
0;0;0;0;0;0;0;0;0;1;0;0;1;0;0;0;0;0;0;0;0;0;0;3;0;0;0;0;3;0;0;0;0;0;0;0;5
0;0;0;6;0;0;0;0;0;1;0;0;1;0;0;3;0;0;0;6;0;0;0;3;0;0;0;0;0;3;0;0;0;0;0;0;5
2;2;2;2;2;2;2;2;2;2;2;2;2;2;2;2;2;2;2;2;2;2;2;3;2;2;2;2;2;2;2;2;2;0;0;2;2
